6
12
1
##############
#   P1  P2     #
# T1GGG   B   #
#    S1   O   #
# BBBB     G #
#  T1      P3  #
#   P4   G    #
##############