9
14
2
#################
#      P1       #
# T1GGT1  B O B H#
#    S1   O  H  #
#  BBB     G   #
#  T1      P2    #
# H H H   H    #
#   OS2   B     #
#           OG #
# OGT2  T2 G     #
##################