6
12
1
##############
#S1 H     P1   #
#   B   #  G #
#    G B     #
#            #
#            #
#            #
##############