6

12

1

##############

#T1 H     P1   #

# G GG  O  G #

#    G B   B #

#  BBBB   GB #

#     S1   O  #

# T1    G  P2  #

##############