7
10
1
############
#G        G#   
# GHB  BHG #
#   HBH    #
#   BP1B    #
#   HBH    #
# GHB  BHGG#
#  G H     #
############