9
14
2
#################
#      P1       #
# T1GG   B   B H#
#    S1 # O  H  #
##BBB  #   G   #
#  T1   #  P2    #
#      ###     #
#  P3 S2   B     #
#     P4     OG #
#  GT2  T2 G     #
##################