6
12
1
##############
#T1     P1     #
#  GGG   B   #
#    S1   O   #
# BBBB     G #
#   P2   P3    #
# T1     G P4  #
##############