9
14
2
#################
#      P1      ##
# T1GGT1  B O B H#
#### S1   O  H  #
# BB B     G   #
#  T1      P2#####
# H H H P3 H    #
#   O    B     #
#  S2P4       OG #
# OGT2  T2 G     #
##################