9
14
2
#################
#      P1       #
# T1GG   B   B H#
#    S1   O  H  #
# BBBB     G   #
#  T1      P2    #
#              #
#    S2   B     #
#           OG #
#  GT2  T2 G     #
##################