6
12
1
##############
#T1 H     P1   #
#   B   O  G #
#    G       #
#  B   B  G  #
#     S1   O  #
#BT1    G  P2  #
##############