7
10
1
############
#          #   
# GO    OG #
#   OBO    #
#   BP1B    #
#   OBO    #
# GO    OG #
#    O     #
############