6
12
1
##############
#T1 H     P1 B #
#       O  G #
#    G     B #
#  B      GB #
#     S1   O  #
# T1    G  P2  #
##############