6
12
1
##############
#      P1     #
# T1GGG   B   #
#    S1   O   #
# BBBB     G #
#  T1      P2  #
#       G    #
##############