6
12
1
##############
#T1 H     P1   #
# G     O  G #
#    G B   B #
#  BB     GB #
#     S1   O  #
# T1    G  P2  #
##############