6
12
1
##############
#T1    O      #
#  GGG   B   #
#    S1   O   #
# BBBBO    G #
#   P1  O     #
#T1   O  G    #
##############