6
12
1
##############
#S1 H     P1   #
#   B   O  G #
# B  G B     #
#      B     #
#         O  #
#            #
##############