9
14
2
#################
#      P1       #
# T1GGT1  B O B H#
#    S1   O  H  #
# BBBB     G   #
#  T1      P2    #
# H H H P3 H    #
#   OS2   B     #
#   P4       OG #
# OGT2  T2 G     #
##################